客厅->living_room
玄关->entryway
屋内->home
温度->temperature
湿度->humidity
亮度->brightness
二氧化碳浓度->co2ppm
关灯->Bulb.turn_bulb_off
开灯->Bulb.turn_bulb_on
开冷空调->AirConditioner.turn_ac_cool
开热空调->AirConditioner.turn_ac_heat
关空调->AirConditioner.turn_ac_off
开门->Door.open_door
关门->Door.close_door
开窗->Window.open_window
关窗->Window.close_window
开窗帘->Blind.open_blind
关窗帘->Blind.close_blind
关闭空气净化器->AirPurifier.turn_ap_off
打开空气净化器->AirPurifier.turn_ap_on
关闭加湿器->Humidifier.turn_hum_off
打开加湿器->Humidifier.turn_hum_on
关闭干燥器->Dehumidifier_0.turn_dehum_off
打开干燥器->Dehumidifier_0.turn_dehum_on
关电扇->Fan.turn_fan_off
开电扇->Fan.turn_fan_on
启动扫地机器人->Robot.start_robot
停止扫地机器人->Robot.dock_robot
允许监视室内->Camera.turn_camera_on
禁止监视室内->Camera.turn_camera_off
二氧化碳浓度需要降低->co2.ppm-
天黑->brightness<50
有人->NOT_Person.Out
没人->Person.Out
下雨->Rain.isRain
灯打开->Bulb.bon
灯关闭->Bulb.boff
门打开->Door.dopen
门关闭->Door.dclosed
窗打开->Window.wopen
窗关闭->Window.wclosed
窗帘打开->Blind.bopen
窗帘关闭->Blind.bclosed
空调制冷->AirConditioner.cool
空调制热->AirConditioner.heat
空调关闭->AirConditioner.acoff
空气净化器关闭->AirPurifier.apoff
空气净化器打开->AirPurifier.apon
加湿器关闭->Humidifier.hoff
加湿器打开->Humidifier.hon
干燥器关闭->Dehumidifier.dhoff
干燥器打开->Dehumidifier.dhon
电扇关闭->Fan.foff
电扇打开->Fan.fon
扫地机器人启动->Robot.roff
扫地机器人停止->Robot.ron
摄像头关闭->Camera.coff
摄像头打开->Camera.con
